############
#          #
#    x     #
#    |     #
#    |     #
#    |     #
#    \-o   #
#          #
############