############
#          #
# x----/   #
#      |   #
#      |   #
#      |   #
#      /-o #
#          #
############