############
#          #
#    x     #
#    |     #
#    |     #
#    |     #
#    /-o   #
#          #
############