############
#    o     #
#    |     #
#    |     #
#    |  x  #
#  /-/  |  #
#  \----/  #
#          #
############