############
#          #
# x----\   #
#      |   #
#      |   #
#      |   #
#      \-o #
#          #
############